{
    "name": "default",
    "layout": [
        "..BBBBBBBBBBBBBBBBBBBBBBBBBBBBBBBBBBBBBBBBBB",
        "...........................................B",
        "RRRRRRRRRRRRRRRRRRRRRRRRRRRRRRRRRRRRRRRRRR.B",
        "R...R........................R...........R.B",
        "R...R.BBBBBBBBBBBBBBBB.......W..BBBBBBBB.R.B",
        "R...R.BBBBBBBBBBBBBBBB.......R..BBBBBBBB.R.B",
        "R...R.BBBBBBBBBBBBBBBB.RRRRRRR..BBBBBBBB.R.B",
        "RRWRR.BBBBBBBBBBBBBBBB.R........BBBBBBBB.R.B",
        "R...R.BBBBBBBBBBBBBBBB.R.BBBBBBBBBBBBBBB.R.B",
        "R.B.R.BBBBBBBBBBBBBBBB.R.BBBBBBBBBBBBBBB.R.B",
        "R...R..................R.BBBBBBBBBBBBBBB.R.B",
        "RRRRRRRRRRRRRRRRR......R...........BBBBB.R.B",
        "R...............RRRRRRRRRRRRRRRRRR.BBBBB.R.B",
        "R.BBBBBBBBBBBBB.R..R......R......R.BBBBB.R.B",
        "R.BBBBBBBBBBBBB.R..W..BB..W..BB..W.BBBBB.R.B",
        "R.BBBBBBBBBBBBB.R..R......R......R....BB.R.B",
        "R.BBBBBBBBBBBBB.RRRRRRRRRRRRRRRRRRRRRR.B.R.B",
        "RRRRRRRRRRRRRRRRR............R.BBBBB.R.B.R.B",
        "R.BBBBBBRBBBBBB.R.BBBBBBBBBB.R.BBBBB.R.B.R.B",
        "R.BBBBBBRBBBBBB.R.BBBBBBBBBB.R.BBBBB.R.B.R.B",
        "R.BBBBBBRBBBBBB.R.BBBBBBBBBB.R.BBBBB.R.B.R.B",
        "R.......R.BBBBB.R.BBBBBBBBBB.R.B.....R.B.R.B",
        "RRRRRRRRR.BBBBB.R.BBBBBBBBBB.RPB.....R...R.B",
        "....R.B.R.BBBBB.R............R.B.WRRRRRWRR.B",
        ".WRRR.B.R.BBBBB.RRRRRRRRR....R.B.R...R.....B",
        "....R.B.R.BBBBB.R.......RRRWRR.B.RRRRR......",
        ".BB.R.B.R.......R.BBBBB.R....R...R..........",
        ".BB.R.B.RRRRRRRRR.BBBBB.R.BB.RRRRRRRRRBBBBBB",
        ".BB.R...R.......R.BBBBB.R.BB.R...R.BBRBBBBBB",
        ".BB.RRWRR.BBBBB.W.BBBBB.R.BB.RRWRR.BBRBBBBBB",
        ".BB.R...R.......R.......R....R...R.BBRBBBBBB",
        ".BB.RRRRRRRRRRRRRRRRRRRRRRRRRRRRRRRRRRBBBBBB",
        ".BB.......R...R...R...R...R........BBBBBBBBB",
        ".BBBBBB...R...R...R...R...R..BBBBBBBBBBBBBBB",
        ".BBBBBB..MR..MR..MR..MR..MR..BBBBBBBBBBBBBBB",
        ".BBBBBB..MS..MS..MS..MS..MS..BBBBBBBBBBBBBBB",
        ".........MM..MM..MM..MM..MM..BBBBBBBBBBBBBBB"
    ]
}